11111111111111111111111
100000E0000000000000001
10C000C0000000000000001
10000000000000000000001
1000000PCC0000000000001
11111111111111111111111