111111111111111111111111111
110000E00000000000000000001
10C0P0C00000000100000000001
100000000000000000000000001
10000000CC00000000000000001
100000000000000000000000001
10000000X00000000X000000001
100000000000000000000000001
111111111111111111111111111