111111111
100010001
100010E01
10C010P01
1E0010001
100110001
100110C01
100000001
111111111