111111111111111111111111111
110000E00000000000000000001
10C000C00000000100000000001
100000P00000000000000000001
10000000CC00000000000000001
100000100X00000000000000001
100000000000000000000000001
1000000000000000000X0000001
111111111111111111111111111