111111111111111111111111111
110000E00000000000000000001
10CP00C00000000100000000001
100000000000000000000000001
10000000CC00000000000000001
100000000000000000000000001
100000000000000000000000001
100000000000000000000000001
111111111111111111111111111