11111111111111111111111111111111111111111
110000E0000000000000000000000000000000001
10CP00C0000000010000000000000000000000001
10000000000000000000000000000000000000001
10000000CC0000000000000000000000000000001
11111111111111111111111111111111111111111