1111111111111111111111111111111111
1000100010000000000000000000000001
100010E000000000000000000000000001
10C010P010000000000000000000000001
1111111111111E11111111111111111111